********************
* P                *
*                  *
*                  *
*                  *
*        M         *
*                  *
*                  *
*                 G*
********************